apeɦaˀmõ	a p e ɦ aˀ m õ
cɨ*ɨsosikɨmɨ̃	c ɨ * ɨ s o s i k ɨ m ɨ̃
kʰoˀɾɨmɨ̃	kʰ oˀ ɾ ɨ m ɨ̃
caʔo	c a ʔ o
tʰaɲeˀ	tʰ a ɲ eˀ
oˀnonaˀ	oˀ n o n aˀ
cjo*oɲjũ	c j o * o ɲ j ũ
utiˀkiɨ	u t iˀ k i ɨ
ɦaaɲjũ	ɦ a a ɲ j ũ
βito	β i t o
cacawa*i	c a c a w a * i
ɲjaɦɨ̃*ɨ̃	ɲ j a ɦ ɨ̃ * ɨ̃
mikapɨ	m i k a p ɨ
poˀnɨ̃mɨ̃	p oˀ n ɨ̃ m ɨ̃
kõnsaa	k õ n s a a
coˀcomẽ	c oˀ c o m ẽ
kʰo*ɨmɨ̃	kʰ o * ɨ m ɨ̃
hoˀhomɨ̃	h oˀ h o m ɨ̃
wese	w e s e
owɨˀ	o w ɨˀ
pinimõ	p i n i m õ
kaɦosɨmakɨ	k a ɦ o s ɨ m a k ɨ
ɦo*e	ɦ o * e
oˀomɨ̃	oˀ o m ɨ̃
maˀɲokʰo	m aˀ ɲ o kʰ o
acoʔaio	a c o ʔ a i o
ĩʔĩ	ĩ ʔ ĩ
ɨ*ɨmɨ̃	ɨ * ɨ m ɨ̃
ɸa*aˀceˀ	ɸ a * aˀ c eˀ
pã*imɨ̃	p ã * i m ɨ̃
huɦuce	h u ɦ u c e
kʰoˀsa	kʰ oˀ s a
kũnae*a	k ũ n a e * a
pinimɨ̃	p i n i m ɨ̃
koɾɨmɨ̃	k o ɾ ɨ m ɨ̃
caˀciomɨ̃	c aˀ c i o m ɨ̃
aio	a i o
sunkikʰa	s u n k i kʰ a
nɨkʰemɨ̃	n ɨ kʰ e m ɨ̃
casamɨ̃	c a s a m ɨ̃
hoˀhomɨ	h oˀ h o m ɨ
wawamɨ̃	w a w a m ɨ̃
tʰotʰacje	tʰ o tʰ a c j e
apema*mɨ̃	a p e m a * m ɨ̃
pĩa	p ĩ a
mɨõɲjo	m ɨ õ ɲ j o
kʰo*ɨme	kʰ o * ɨ m e
ceɾo	c e ɾ o
neˀnemaˀmɨ̃	n eˀ n e m aˀ m ɨ̃
hu*epɨ	h u * e p ɨ
piˀnime	p iˀ n i m e
tʰaɾaˀ	tʰ a ɾ aˀ
oʔaˀ	o ʔ aˀ
ca*ũmɨ̃	c a * ũ m ɨ̃
ɸem	ɸ e m
sẽnseˀ	s ẽ n s eˀ
ha*ɨkutʰumamɨ̃	h a * ɨ k u tʰ u m a m ɨ̃
maɲoko	m a ɲ o k o
uˀkũ	uˀ k ũ
aũ	a ũ
tʰoa	tʰ o a
makaɾɨ	m a k a ɾ ɨ
si*ũɲɨ̃	s i * ũ ɲ ɨ̃
ɦa*ãɲɨ̃	ɦ a * ã ɲ ɨ̃
i*i	i * i
nenemaˀmɨ̃	n e n e m aˀ m ɨ̃
hɨ*epɨ	h ɨ * e p ɨ
ɲjaɲjumɨ̃	ɲ j a ɲ j u m ɨ̃
teˀteɾɨ	t eˀ t e ɾ ɨ
tʰããɲje	tʰ ã ã ɲ j e
aˀco	aˀ c o
tʰoɲoɲe	tʰ o ɲ o ɲ e
naˀaso	n aˀ a s o
cɨcɨ	c ɨ c ɨ
nẽ*ẽɲjɨ	n ẽ * ẽ ɲ j ɨ
kʰaiɲjieˀ	kʰ a i ɲ j i eˀ
siˀsi	s iˀ s i
o*a	o * a
cɨɨsosikɨamɨ̃	c ɨ ɨ s o s i k ɨ a m ɨ̃
maʔa	m a ʔ a
tʰ*oo	tʰ * o o
henã	h e n ã
ʔũkʰupiˀamɨ̃	ʔ ũ kʰ u p iˀ a m ɨ̃
ɲjãkʰɨ	ɲ j ã kʰ ɨ
ɸa*aceˀ	ɸ a * a c eˀ
cjokʰoˀɲjaˀ	c j o kʰ oˀ ɲ j aˀ
koɨo	k o ɨ o
cɨ*ɨmɨ̃	c ɨ * ɨ m ɨ̃
ɾaɲja	ɾ a ɲ j a
apemamɨ	a p e m a m ɨ
casasosikwamɨ̃	c a s a s o s i k w a m ɨ̃
matɨˀkʰarɨˀ	m a t ɨˀ kʰ a r ɨˀ
ɲjaɲje	ɲ j a ɲ j e
ɸe*emɨ	ɸ e * e m ɨ
emũ	e m ũ
caʔi	c a ʔ i
ɸemɨ	ɸ e m ɨ
poneme	p o n e m e
ʔɨ*ɨmɨ̃	ʔ ɨ * ɨ m ɨ̃
ũkupiramɨ̃	ũ k u p i r a m ɨ̃
mahaˀco	m a h aˀ c o
kweˀkomɨ̃	k w eˀ k o m ɨ̃
wekʰɨ	w e kʰ ɨ
ɲauɲamɨ	ɲ a u ɲ a m ɨ
ɾaɲa	ɾ a ɲ a
oˀnona	oˀ n o n a
õnõnã	õ n õ n ã
e*amɨ̃	e * a m ɨ̃
katapɨ	k a t a p ɨ
ukupiamɨ̃	u k u p i a m ɨ̃
ɲakʰɨ	ɲ a kʰ ɨ
teˀteɨ	t eˀ t e ɨ
ãũɦɨ*ɨ̃	ã ũ ɦ ɨ * ɨ̃
ʔeamɨ̃	ʔ e a m ɨ̃
cjokʰoˀ*a	c j o kʰ oˀ * a
paiɨ	p a i ɨ
ha*ãɲjɨ̃	h a * ã ɲ j ɨ̃
eose*e	e o s e * e
ɦa*omoˀoɾaɲjapeomõ	ɦ a * o m oˀ o ɾ a ɲ j a p e o m õ
ɦɨ̃tʰɨ	ɦ ɨ̃ tʰ ɨ
ɨmɨɨ	ɨ m ɨ ɨ
ɲaɦɨ̃*ɨ̃	ɲ a ɦ ɨ̃ * ɨ̃
siˀsiaˀ	s iˀ s i aˀ
nãso	n ã s o
cjo*oˀceˀ	c j o * oˀ c eˀ
toˀatokamɨ̃	t oˀ a t o k a m ɨ̃
matɨkaɾɨ	m a t ɨ k a ɾ ɨ
pitome	p i t o m e
si*emɨ̃	s i * e m ɨ̃
ɨmɨ	ɨ m ɨ
ci*ime	c i * i m e
ɾo*imɨ̃	ɾ o * i m ɨ̃
mikʰapɨ	m i kʰ a p ɨ
cjẽmẽpɨˀ	c j ẽ m ẽ p ɨˀ
peumɨ̃	p e u m ɨ̃
cokoa	c o k o a
asiɾeˀɾeβa	a s i ɾ eˀ ɾ e β a
ca*opo	c a * o p o
wiˀtʰo	w iˀ tʰ o
ɦa*o	ɦ a * o
mukʰamɨ̃	m u kʰ a m ɨ̃
kɨnaɾea	k ɨ n a ɾ e a
hu*iepakʰa	h u * i e p a kʰ a
emuˀ	e m uˀ
ɾaɲjaˀ	ɾ a ɲ j aˀ
t͡ʃɨopi	t͡ʃ ɨ o p i
insi	i n s i
peoreˀ	p e o r eˀ
cjoˀ*oɦɨ̃*ɨ̃	c j oˀ * o ɦ ɨ̃ * ɨ̃
mapɨ̃a	m a p ɨ̃ a
cɨkʰoˀwɨˀ	c ɨ kʰ oˀ w ɨˀ
βiˀtʰo	β iˀ tʰ o
hoˀɦomɨ̃	h oˀ ɦ o m ɨ̃
cokʰoɲa	c o kʰ o ɲ a
so*to	s o * t o
ɲjakʰɨ	ɲ j a kʰ ɨ
mã	m ã
biˀnĩmõ	b iˀ n ĩ m õ
ɲjamaˀ	ɲ j a m aˀ
βɨeβɨɦɨ	β ɨ e β ɨ ɦ ɨ
cɨ̃ɨsosikamɨ̃	c ɨ̃ ɨ s o s i k a m ɨ̃
miaɲjẽ	m i a ɲ j ẽ
ĩ*ĩ	ĩ * ĩ
ĩsipɨ	ĩ s i p ɨ
ɸeˀnẽmɨ̃	ɸ eˀ n ẽ m ɨ̃
soto	s o t o
cjacjawaʔi	c j a c j a w a ʔ i
sɨˀsɨ	s ɨˀ s ɨ
ɦaˀkʰowɨ	ɦ aˀ kʰ o w ɨ
ɲjaɦɨ̃*ɨɦaˀkʰowɨ	ɲ j a ɦ ɨ̃ * ɨ ɦ aˀ kʰ o w ɨ
sĩɦopɨa	s ĩ ɦ o p ɨ a
siɦopɨa	s i ɦ o p ɨ a
hoɦomɨ	h o ɦ o m ɨ
ĩnsiˀpɨ	ĩ n s iˀ p ɨ
nẽatõ	n ẽ a t õ
pooa	p o o a
cai	c a i
neatʰo	n e a tʰ o
maɦaco	m a ɦ a c o
apeamaˀmɨ	a p e a m aˀ m ɨ
kawana	k a w a n a
ɾaɲjã	ɾ a ɲ j ã
totʰace	t o tʰ a c e
aioˀ	a i oˀ
sĩ*ũɲɨ̃	s ĩ * ũ ɲ ɨ̃
βu*e	β u * e
huiɾepakʰa	h u i ɾ e p a kʰ a
miaɲje	m i a ɲ j e
nẽ*ẽɲjɨ̃	n ẽ * ẽ ɲ j ɨ̃
poɦaˀce	p o ɦ aˀ c e
mɨoɲjo	m ɨ o ɲ j o
o*o	o * o
aco	a c o
ha*aɲjɨ̃	h a * a ɲ j ɨ̃
moɲjoˀ	m o ɲ j oˀ
pohace	p o h a c e
nɨ̃kemɨ̃	n ɨ̃ k e m ɨ̃
owɨ	o w ɨ
tʰoapɨ	tʰ o a p ɨ
maɲokʰo	m a ɲ o kʰ o
paimɨ	p a i m ɨ
cecoce	c e c o c e
sĩɦopɨ	s ĩ ɦ o p ɨ
sunkikʰã	s u n k i kʰ ã
tʰokamɨ̃	tʰ o k a m ɨ̃
maˀkaɾɨ	m aˀ k a ɾ ɨ
mĩkabɨ	m ĩ k a b ɨ
eʔamɨ̃	e ʔ a m ɨ̃
ha*aɲɨnẽ*eɲjɨ̃maˀmɨ	h a * a ɲ ɨ n ẽ * e ɲ j ɨ̃ m aˀ m ɨ
sisomɨ̃	s i s o m ɨ̃
ne*eɲjũ	n e * e ɲ j ũ
okʰo	o kʰ o
kuˀtuˀceˀ	k uˀ t uˀ c eˀ
aˀpẽ*ɨ̃amaˀmo	aˀ p ẽ * ɨ̃ a m aˀ m o
mɨkʰamɨ̃	m ɨ kʰ a m ɨ̃
peɨmɨ̃	p e ɨ m ɨ̃
pito	p i t o
ɦaʔɨ	ɦ a ʔ ɨ
sɨ̃sɨ	s ɨ̃ s ɨ
siˀɾemɨ̃	s iˀ ɾ e m ɨ̃
ɲjaˀseˀ	ɲ j aˀ s eˀ
aaˀsosaiwɨ	a aˀ s o s a i w ɨ
ie	i e
kʰomaˀɲe	kʰ o m aˀ ɲ e
moɲjo	m o ɲ j o
apemaˀmɨ	a p e m aˀ m ɨ
ɨmea	ɨ m e a
cɨsosikɨamɨ̃	c ɨ s o s i k ɨ a m ɨ̃
ãkapɨ̃	ã k a p ɨ̃
kuˀtumamɨ̃	k uˀ t u m a m ɨ̃
cɨsosikʰamɨ̃	c ɨ s o s i kʰ a m ɨ̃
haʔa	h a ʔ a
tʰeˀtʰeɾɨ	tʰ eˀ tʰ e ɾ ɨ
kamamo	k a m a m o
kata	k a t a
koo	k o o
weˀwoɲɨ̃	w eˀ w o ɲ ɨ̃
tʰo*oɾo	tʰ o * o ɾ o
ca*umɨ̃	c a * u m ɨ̃
ai	a i
kõnsaka*	k õ n s a k a *
kʰoˀɦi	kʰ oˀ ɦ i
ma*akaɾɨ	m a * a k a ɾ ɨ
utʰikirɨ	u tʰ i k i r ɨ
oo	o o
cjɨmɨ̃	c j ɨ m ɨ̃
kutumamɨ̃	k u t u m a m ɨ̃
coɦɨ*ɨ	c o ɦ ɨ * ɨ
kʰũkʰuce	kʰ ũ kʰ u c e
cjɨsosiˀkɨa*mɨ̃	c j ɨ s o s iˀ k ɨ a * m ɨ̃
caumɨ̃	c a u m ɨ̃
kɨnaɾeaβa	k ɨ n a ɾ e a β a
ũkʰupiˀɾamɨ̃	ũ kʰ u p iˀ ɾ a m ɨ̃
cɨ*ɨkʰowɨ	c ɨ * ɨ kʰ o w ɨ
hitu	h i t u
caĩ	c a ĩ
ũnkupiramẽ	ũ n k u p i r a m ẽ
ʔũkupiramɨ̃	ʔ ũ k u p i r a m ɨ̃
u*utiˀkiɾɨ	u * u t iˀ k i ɾ ɨ
ɲãɦɨ̃*ɨ̃	ɲ ã ɦ ɨ̃ * ɨ̃
βɨeβɨɦɨˀ	β ɨ e β ɨ ɦ ɨˀ
tʰoapɨ̃	tʰ o a p ɨ̃
hĩtʰu	h ĩ tʰ u
ooˀpɨ	o oˀ p ɨ
co*omɨ̃	c o * o m ɨ̃
ha*ɨkutʰumaˀmɨ̃	h a * ɨ k u tʰ u m aˀ m ɨ̃
maɦaˀco	m a ɦ aˀ c o
utiˀkiɾɨ	u t iˀ k i ɾ ɨ
ʔβiˀto	ʔ β iˀ t o
mĩ*ã	m ĩ * ã
ɨ̃ɦaβɨ̃	ɨ̃ ɦ a β ɨ̃
kũnaeawaˀ	k ũ n a e a w aˀ
ɲaɦɨ*ɨ	ɲ a ɦ ɨ * ɨ
soˀto	s oˀ t o
sisia	s i s i a
ɲjamɨ̃	ɲ j a m ɨ̃
caˀcomẽ	c aˀ c o m ẽ
kʰaiɲjeˀ	kʰ a i ɲ j eˀ
mɨoɲo	m ɨ o ɲ o
aiˀ	a iˀ
taɾa	t a ɾ a
wiˀtʰokʰa	w iˀ tʰ o kʰ a
tʰamɨ̃	tʰ a m ɨ̃
haɲɨneɲɨmamɨ̃	h a ɲ ɨ n e ɲ ɨ m a m ɨ̃
kʰomaneɦɨ*ɨ	kʰ o m a n e ɦ ɨ * ɨ
kunaɾeaβa	k u n a ɾ e a β a
au	a u
kɨnaβaɦɨ	k ɨ n a β a ɦ ɨ
sẽsẽ	s ẽ s ẽ
maˀpɨaˀ	m aˀ p ɨ aˀ
matʰɨˀkʰaɨ̃	m a tʰ ɨˀ kʰ a ɨ̃
oʔa	o ʔ a
kaiɲe	k a i ɲ e
poˀʔo	p oˀ ʔ o
kɨ̃naβaɦɨ̃	k ɨ̃ n a β a ɦ ɨ̃
weweɲɨ̃	w e w e ɲ ɨ̃
iɦace	i ɦ a c e
ka*amɨ̃	k a * a m ɨ̃
kʰoʔɨmɨ̃	kʰ o ʔ ɨ m ɨ̃
kʰatʰapɨ	kʰ a tʰ a p ɨ
ĩnsi	ĩ n s i
katʰapɨ	k a tʰ a p ɨ
cjokʰoˀʔa	c j o kʰ oˀ ʔ a
kʰã	kʰ ã
haˀ*ɨ	h aˀ * ɨ
cimo	c i m o
ɦaˀkʰɨ	ɦ aˀ kʰ ɨ
kõsacja	k õ s a c j a
ɾe*omɨ	ɾ e * o m ɨ
bãĩ	b ã ĩ
poʔoˀ	p o ʔ oˀ
pitʰomẽ	p i tʰ o m ẽ
aˀsosaiwɨ	aˀ s o s a i w ɨ
aĩ	a ĩ
aˀpẽmaˀmɨ	aˀ p ẽ m aˀ m ɨ
tokatokamɨ̃	t o k a t o k a m ɨ̃
wito	w i t o
ɲjãtʰa	ɲ j ã tʰ a
ɸwemɨ̃	ɸ w e m ɨ̃
kʰoˀrɨmɨ̃	kʰ oˀ r ɨ m ɨ̃
ieˀ	i eˀ
ceˀcomẽ	c eˀ c o m ẽ
ɾaɲjapeomõ	ɾ a ɲ j a p e o m õ
ha*ʔo	h a * ʔ o
miaɲjeˀ	m i a ɲ j eˀ
aˀpẽmaˀmɨ̃	aˀ p ẽ m aˀ m ɨ̃
siˀswemɨ̃	s iˀ s w e m ɨ̃
ɨɦacaɨa	ɨ ɦ a c a ɨ a
ãkapɨ	ã k a p ɨ
ɲjatʰa	ɲ j a tʰ a
auhɨ*ɨ	a u h ɨ * ɨ
ciˀ*ime	c iˀ * i m e
cuˀʔcu	c uˀ ʔ c u
caˀcomɨ̃	c aˀ c o m ɨ̃
kãɦoasamamɨ̃	k ã ɦ o a s a m a m ɨ̃
cjokʰo*aˀ	c j o kʰ o * aˀ
jacjawaʔi	j a c j a w a ʔ i
nẽnẽmɨ̃	n ẽ n ẽ m ɨ̃
wiˀto	w iˀ t o
kʰomaneɨ*ɨ	kʰ o m a n e ɨ * ɨ
pãĩ	p ã ĩ
konsa	k o n s a
pitoˀ	p i t oˀ
ne*emaˀmɨ̃	n e * e m aˀ m ɨ̃
sĩhopɨ	s ĩ h o p ɨ
ha*ane*eɲjũmaˀmɨ̃	h a * a n e * e ɲ j ũ m aˀ m ɨ̃
cjo*oɲũ	c j o * o ɲ ũ
kutumaˀmɨ	k u t u m aˀ m ɨ
mapɨã	m a p ɨ ã
ɦena	ɦ e n a
naso	n a s o
ɾĩɦomɨ̃	ɾ ĩ ɦ o m ɨ̃
kʰomoˀ	kʰ o m oˀ
makaɨ	m a k a ɨ
tʰoˀkamɨ̃	tʰ oˀ k a m ɨ̃
kõnsaˀka	k õ n s aˀ k a
kosoca	k o s o c a
waˀwamɨ̃	w aˀ w a m ɨ̃
sinɦopɨ̃	s i n ɦ o p ɨ̃
ɲjãɲje	ɲ j ã ɲ j e
ɾeomɨ̃	ɾ e o m ɨ̃
kɨnaɾe**aβa	k ɨ n a ɾ e * * a β a
sĩnɦopɨ̃a	s ĩ n ɦ o p ɨ̃ a
tʰetʰeɨ	tʰ e tʰ e ɨ
ɦa*aneɲumamɨ̃	ɦ a * a n e ɲ u m a m ɨ̃
aɲja	a ɲ j a
iˀse	iˀ s e
βuʔe	β u ʔ e
tʰaɾa	tʰ a ɾ a
ɨɦacaiwa	ɨ ɦ a c a i w a
sɨ̃nsɨ	s ɨ̃ n s ɨ
sĩsi	s ĩ s i
nenemamɨ̃	n e n e m a m ɨ̃
matɨˀkʰarɨ	m a t ɨˀ kʰ a r ɨ
ɾe*omɨ̃	ɾ e * o m ɨ̃
ca*o	c a * o
kʰunkuce	kʰ u n k u c e
coˀcomɨ̃	c oˀ c o m ɨ̃
mĩkʰabɨ	m ĩ kʰ a b ɨ
mimĩ	m i m ĩ
ɲjãɦɨ*	ɲ j ã ɦ ɨ *
eoseˀwe	e o s eˀ w e
ɲatʰa	ɲ a tʰ a
ca*ɨmɨ	c a * ɨ m ɨ
ne*eɲũ	n e * e ɲ ũ
ooˀ	o oˀ
ɲaɦɨ	ɲ a ɦ ɨ
cjẽmepɨˀ	c j ẽ m e p ɨˀ
ise	i s e
cjo*omɨ̃	c j o * o m ɨ̃
ma*aˀkaɾɨ	m a * aˀ k a ɾ ɨ
tʰoˀnoɲe	tʰ oˀ n o ɲ e
siɾemo	s i ɾ e m o
ɲãũɲã*ũmɨ̃	ɲ ã ũ ɲ ã * ũ m ɨ̃
cɨmamɨ̃	c ɨ m a m ɨ̃
kunaɾe*a	k u n a ɾ e * a
ikame	i k a m e
toatokamɨ̃	t o a t o k a m ɨ̃
ceˀɾo	c eˀ ɾ o
aiˀpaˀ	a iˀ p aˀ
pitʰo	p i tʰ o
tʰotʰace	tʰ o tʰ a c e
cĩwã*õ	c ĩ w ã * õ
aiˀpa	a iˀ p a
cjacjawai	c j a c j a w a i
koɦĩ	k o ɦ ĩ
ẽmũ	ẽ m ũeamɨ e a m ɨ
ocosiβi	o c o s i β i
ooomɨ̃	o o o m ɨ̃
e*ose*e	e * o s e * e
weˀkʰɨˀ	w eˀ kʰ ɨˀ
ɸa*ace	ɸ a * a c e
nɨˀkamɨ	n ɨˀ k a m ɨ
ɨɦajaiwa	ɨ ɦ a j a i w a
cɨkɨna	c ɨ k ɨ n a
iẽ	i ẽ
cɨsosikaˀmɨ̃	c ɨ s o s i k aˀ m ɨ̃
ʔoʔa	ʔ o ʔ a
apeɲu	a p e ɲ u
sĩsomɨ̃	s ĩ s o m ɨ̃
tʰo*oo	tʰ o * o o
iɦaˀce	i ɦ aˀ c e
matʰɨˀkaɨ̃	m a tʰ ɨˀ k a ɨ̃
kɨnaɾe*aβa	k ɨ n a ɾ e * a β a
heɦemɨ̃	h e ɦ e m ɨ̃
mapɨa	m a p ɨ a
toɾo	t o ɾ o
ooɾomɨ̃	o o ɾ o m ɨ̃
βɨeβɨɦi	β ɨ e β ɨ ɦ i
aˀsiceˀ	aˀ s i c eˀ
ɲjaˀse	ɲ j aˀ s e
cjoˀcje	c j oˀ c j e
matɨˀkaɾɨ	m a t ɨˀ k a ɾ ɨ
u*utʰikiɾɨ	u * u tʰ i k i ɾ ɨ
peorẽ	p e o r ẽ
naˀsoˀ	n aˀ s oˀ
kutʰuma*mɨ̃	k u tʰ u m a * m ɨ̃
coˀcomɨ	c oˀ c o m ɨ
mi*aˀ	m i * aˀ
tsɨˀtsɨˀ	t s ɨˀ t s ɨˀ
ɦaʔoɾaɲjapeomõ	ɦ a ʔ o ɾ a ɲ j a p e o m õ
huiepakʰa	h u i e p a kʰ a
kamɨ̃	k a m ɨ̃
coˀɲu	c oˀ ɲ u
kʰokʰomaˀmɨ̃	kʰ o kʰ o m aˀ m ɨ̃
asosaibɨ	a s o s a i b ɨ
ɲaɲũmɨ̃	ɲ a ɲ ũ m ɨ̃
ɦeˀɦemɨ̃	ɦ eˀ ɦ e m ɨ̃
sunkĩkʰa	s u n k ĩ kʰ a
ɾɨahuɦu	ɾ ɨ a h u ɦ u
mikabɨ	m i k a b ɨ
βeweɲɨ̃	β e w e ɲ ɨ̃
kʰosa	kʰ o s a
hoɦomɨ̃	h o ɦ o m ɨ̃
ɲaɲumɨ̃	ɲ a ɲ u m ɨ̃
kosaka	k o s a k a
cjɨ̃maˀmɨ̃	c j ɨ̃ m aˀ m ɨ̃
aˀpeɦaˀmõ	aˀ p e ɦ aˀ m õ
tʰaɾapɨˀ	tʰ a ɾ a p ɨˀ
apẽɲjũ	a p ẽ ɲ j ũ
βitoka	β i t o k a
ha*aɲɨ	h a * a ɲ ɨ
asiɾeˀɾewɨ	a s i ɾ eˀ ɾ e w ɨ
miʔa	m i ʔ a
maha*ɲjẽ	m a h a * ɲ j ẽ
apeɦamo	a p e ɦ a m o
cjɨ*ɨkʰowɨ	c j ɨ * ɨ kʰ o w ɨ
uˀcao	uˀ c a o
uhaɨ	u h a ɨ
kosaca	k o s a c a
ne*eɲu	n e * e ɲ u
oβɨ	o β ɨ
maɦaɲjɨ	m a ɦ a ɲ j ɨ
pai	p a i
paʔimɨ	p a ʔ i m ɨ
βitʰo	β i tʰ o
ũku	ũ k u
ɦã*ɨ̃saimɨ̃	ɦ ã * ɨ̃ s a i m ɨ̃
apecje	a p e c j e
e*ɨmɨ̃	e * ɨ m ɨ̃
neneɲe	n e n e ɲ e
ca*i	c a * i
βeˀβɨ	β eˀ β ɨ
matʰɨkʰaɨ̃	m a tʰ ɨ kʰ a ɨ̃
toˀkamɨ	t oˀ k a m ɨ
ʔβɨ*eβɨ	ʔ β ɨ * e β ɨ
ɨɦacjaiwa	ɨ ɦ a c j a i w a
maʔakaɨ̃	m a ʔ a k a ɨ̃
asiceˀ	a s i c eˀ
coˀce	c oˀ c e
tʰeˀteɨ	tʰ eˀ t e ɨ
kosa	k o s a
kõsa	k õ s a
kwekomɨ̃	k w e k o m ɨ̃
*ɨ*ɨmɨ̃	* ɨ * ɨ m ɨ̃
cjokʰoˀɲja	c j o kʰ oˀ ɲ j a
cokʰoˀɲa	c o kʰ oˀ ɲ a
asosãĩwɨ	a s o s ã ĩ w ɨ
ɦoˀɦomɨ̃	ɦ oˀ ɦ o m ɨ̃
mũkʰamɨ̃	m ũ kʰ a m ɨ̃
peˀɨmɨ̃	p eˀ ɨ m ɨ̃
pi*a	p i * a
tʰetʰeɾɨ̃	tʰ e tʰ e ɾ ɨ̃
koɦiɲu	k o ɦ i ɲ u
wiˀtʰo*	w iˀ tʰ o *
ce*eo	c e * e o
haʔo	h a ʔ o
okʰoˀ	o kʰ oˀ
peˀrɨmɨ̃	p eˀ r ɨ m ɨ̃
weˀweɲɨ̃	w eˀ w e ɲ ɨ̃
ɦa*oɾaɲjapeomõ	ɦ a * o ɾ a ɲ j a p e o m õ
peˀɾɨmɨ̃	p eˀ ɾ ɨ m ɨ̃
ɲata	ɲ a t a
tʰo*oɨ	tʰ o * o ɨ
cjɨsosikʰɨmɨ̃wet	c j ɨ s o s i kʰ ɨ m ɨ̃ w e t
pamɨ̃	p a m ɨ̃
pitʰome	p i tʰ o m e
neˀnemɨ̃	n eˀ n e m ɨ̃
asoβã	a s o β ã
katʰa	k a tʰ a
mãɲõkʰo	m ã ɲ õ kʰ o
asiɾeɾeβa	a s i ɾ e ɾ e β a
kʰoˀkomaˀmɨ̃	kʰ oˀ k o m aˀ m ɨ̃
kʰukʰuce	kʰ u kʰ u c e
maɲa	m a ɲ a
wiˀtoˀka	w iˀ t oˀ k a
cɨ*ɨsosikʰɨmɨ̃	c ɨ * ɨ s o s i kʰ ɨ m ɨ̃
kʰoˀkʰomaˀmɨ̃	kʰ oˀ kʰ o m aˀ m ɨ̃
ihace	i h a c e
kaimɨ̃	k a i m ɨ̃
akapɨ	a k a p ɨ
kʰomaneɦɨɨ	kʰ o m a n e ɦ ɨ ɨ
ma*akaɨ	m a * a k a ɨ
ka*amaˀmo	k a * a m aˀ m o
maɦaɲe	m a ɦ a ɲ e
hɨntʰɨ	h ɨ n tʰ ɨ
cacomɨ̃	c a c o m ɨ̃
apemɨ̃	a p e m ɨ̃
hena	h e n a
ĩsipɨ̃	ĩ s i p ɨ̃
ha*ɨkutumamɨ̃	h a * ɨ k u t u m a m ɨ̃
ɨmɨɨˀ	ɨ m ɨ ɨˀ
βeβeɲɨ̃	β e β e ɲ ɨ̃
h*a	h * a
βeβeɲɨ	β e β e ɲ ɨ
emɨ̃	e m ɨ̃
co*oɲɨ	c o * o ɲ ɨ
ha*akʰowɨˀ	h a * a kʰ o w ɨˀ
ɦa*ane*eɲjũmamɨ̃	ɦ a * a n e * e ɲ j ũ m a m ɨ̃
aˀso	aˀ s o
cao	c a o
sẽnse	s ẽ n s e
aiˀo	a iˀ o
kʰomo	kʰ o m o
cokoɲa	c o k o ɲ a
neˀneɲe	n eˀ n e ɲ e
peˀrumɨ̃	p eˀ r u m ɨ̃
piˀnĩmõ	p iˀ n ĩ m õ
pĩ*ã	p ĩ * ã
sese	s e s e
ɦa*ɨ	ɦ a * ɨ
a*soβa	a * s o β a
ʔsiˀsiˀ	ʔ s iˀ s iˀ
nukemɨ̃	n u k e m ɨ̃
naˀso	n aˀ s o
apeceˀ	a p e c eˀ
ʔaˀso	ʔ aˀ s o
mĩ*a	m ĩ * a
ɲahɨʔɨ	ɲ a h ɨ ʔ ɨ
βekɨ	β e k ɨ
tʰeteɾɨ	tʰ e t e ɾ ɨ
mĩmĩ	m ĩ m ĩ
kõnsaka	k õ n s a k a
ha*ɨ	h a * ɨ
ɾɨahuhu	ɾ ɨ a h u h u
ka*amaˀmõ	k a * a m aˀ m õ
ɦa*aˀne*eɲũma	ɦ a * aˀ n e * e ɲ ũ m a
ũkupiramẽ	ũ k u p i r a m ẽ
cacaβa*i	c a c a β a * i
eamɨ̃	e a m ɨ̃
ma	m a
asosaiβɨ	a s o s a i β ɨ
kɨnaɾe**a	k ɨ n a ɾ e * * a
kʰoɨme	kʰ o ɨ m e
ɦɨ*epɨ	ɦ ɨ * e p ɨ
kʰaiɲje	kʰ a i ɲ j e
aˀpemamɨ̃	aˀ p e m a m ɨ̃
cjɨmaˀmɨ̃	c j ɨ m aˀ m ɨ̃
mĩãɲjɨ̃	m ĩ ã ɲ j ɨ̃
mimi	m i m i
ɲjãɲjeˀ	ɲ j ã ɲ j eˀ
kãɦoasamaˀmɨ	k ã ɦ o a s a m aˀ m ɨ
sukʰikʰa	s u kʰ i kʰ a
sĩɦoˀpɨ	s ĩ ɦ oˀ p ɨ
haˀ*ɨˀ	h aˀ * ɨˀ
ãũɦɨ̃*ɨ̃	ã ũ ɦ ɨ̃ * ɨ̃
ɸeˀnemɨ̃	ɸ eˀ n e m ɨ̃
neˀnẽmɨ̃	n eˀ n ẽ m ɨ̃
ro*imɨ̃	r o * i m ɨ̃
siˀemɨ̃	s iˀ e m ɨ̃
piˀnimõ	p iˀ n i m õ
auɦɨ*ɨ	a u ɦ ɨ * ɨ
ɾiˀɦomɨ̃	ɾ iˀ ɦ o m ɨ̃
ɸeemɨ̃	ɸ e e m ɨ̃
aˀcoʔaio	aˀ c o ʔ a i o
caopo	c a o p o
co*oce	c o * o c e
cɨmɨ̃	c ɨ m ɨ̃
isipɨ	i s i p ɨ
kʰõsa	kʰ õ s a
uɦaɨ	u ɦ a ɨ
heoseẽɲa	h e o s e ẽ ɲ a
ɦitu	ɦ i t u
koˀsa	k oˀ s a
mahãɲẽ	m a h ã ɲ ẽ
apeamaˀmɨ̃	a p e a m aˀ m ɨ̃
si*ũɲɨ	s i * ũ ɲ ɨ
nẽ*eɲjɨ	n ẽ * e ɲ j ɨ
caũmɨ̃	c a ũ m ɨ̃
kʰokomamɨ̃	kʰ o k o m a m ɨ̃
ceeo	c e e o
ucao	u c a o
kõnsa	k õ n s a
ɾaɲapeomɨ̃	ɾ a ɲ a p e o m ɨ̃
asieˀe	a s i eˀ e
ikʰow	i kʰ o w
kutuˀceˀ	k u t uˀ c eˀ
cjo*õceˀ	c j o * õ c eˀ
ha*orekaɦorotapimaˀ	h a * o r e k a ɦ o r o t a p i m aˀ
witokʰa	w i t o kʰ a
ɦakowɨ	ɦ a k o w ɨ
weˀʔse	w eˀ ʔ s e
ne*neɲe	n e * n e ɲ e
po	p o
cjo*oɦɨ̃*ɨ̃	c j o * o ɦ ɨ̃ * ɨ̃
sisemɨ̃	s i s e m ɨ̃
siˀsiˀ	s iˀ s iˀ
ponɨmɨ̃	p o n ɨ m ɨ̃
ɦa*ɨne*nemɨ̃	ɦ a * ɨ n e * n e m ɨ̃
ɾiɦomɨ̃	ɾ i ɦ o m ɨ̃
haɦaɲjɨne*eɲjɨmaˀmɨ̃	h a ɦ a ɲ j ɨ n e * e ɲ j ɨ m aˀ m ɨ̃
aɲjapeõmõ	a ɲ j a p e õ m õ
ʔo*imɨ̃	ʔ o * i m ɨ̃
mũkamɨ̃	m ũ k a m ɨ̃
ʔũkʰupiˀam	ʔ ũ kʰ u p iˀ a m
ca*õ	c a * õ
aˀcoaio	aˀ c o a i o
kõnsãka	k õ n s ã k a
insipɨ	i n s i p ɨ
ikʰowɨ	i kʰ o w ɨ
hɨtʰɨ	h ɨ tʰ ɨ
ɲjaɦɨ̃ɦaˀkʰowɨ	ɲ j a ɦ ɨ̃ ɦ aˀ kʰ o w ɨ
poɦace	p o ɦ a c e
aɨ̃ɦɨ̃*ɨ̃	a ɨ̃ ɦ ɨ̃ * ɨ̃
ɨɦaβɨ	ɨ ɦ a β ɨ
ɲjãɦɨ*ɨ̃	ɲ j ã ɦ ɨ * ɨ̃
cimõ	c i m õ
pam	p a m
ɲaɲe	ɲ a ɲ e
βɨ*e	β ɨ * e
aˀkapɨ	aˀ k a p ɨ
apemamɨ̃	a p e m a m ɨ̃
hoɦomõ	h o ɦ o m õ
paĩ	p a ĩ
apemɨ	a p e m ɨ
ɦa*orekaɦorotaˀpimaˀ	ɦ a * o r e k a ɦ o r o t aˀ p i m aˀ
neˀnemamɨ̃	n eˀ n e m a m ɨ̃
ɸaace	ɸ a a c e
ĩsi	ĩ s i
hiˀtu	h iˀ t u
ha*orekaɦorotapima	h a * o r e k a ɦ o r o t a p i m a
ũkʰu	ũ kʰ u
βiˀto	β iˀ t o
mãkʰa	m ã kʰ a
ho*e	h o * e
oɾomɨ̃	o ɾ o m ɨ̃
ɲaˀse	ɲ aˀ s e
ponɨ̃mɨ̃	p o n ɨ̃ m ɨ̃
ca*oo	c a * o o
aˀsimakʰaˀ	aˀ s i m a kʰ aˀ
taɾapɨ̃	t a ɾ a p ɨ̃
kũnareawa	k ũ n a r e a w a
huˀʔepɨ	h uˀ ʔ e p ɨ
kʰoɨmɨ̃	kʰ o ɨ m ɨ̃
siuɲjɨ	s i u ɲ j ɨ
ɦaˀɲuˀ	ɦ aˀ ɲ uˀ
ka	k a
e	e
ãiˀpaˀ	ã iˀ p aˀ
apemaˀmɨ̃	a p e m aˀ m ɨ̃
koɦi	k o ɦ i
cio	c i o
ɨ*ɨmɨ	ɨ * ɨ m ɨ
pa*ĩmɨ̃	p a * ĩ m ɨ̃
ɲauɲaumɨ̃	ɲ a u ɲ a u m ɨ̃
asiˀceˀ	a s iˀ c eˀ
maɦaˀɲje	m a ɦ aˀ ɲ j e
tʰokʰamɨ̃	tʰ o kʰ a m ɨ̃
ɦa*a	ɦ a * a
apece	a p e c e
aˀsoˀ	aˀ s oˀ
pa*imɨ̃	p a * i m ɨ̃
aˀpẽɨ̃amaˀmo	aˀ p ẽ ɨ̃ a m aˀ m o
sũnkʰikʰa	s ũ n kʰ i kʰ a
co*oɲu	c o * o ɲ u
saimɨ̃	s a i m ɨ̃
cɨɨɨmamɨ̃	c ɨ ɨ ɨ m a m ɨ̃
ukupiɾamɨ̃	u k u p i ɾ a m ɨ̃
aɨˀ	a ɨˀ
aasosaiwɨ	a a s o s a i w ɨ
caˀʔo	c aˀ ʔ o
koˀɦi	k oˀ ɦ i
poce	p o c e
heˀɦemɨ̃	h eˀ ɦ e m ɨ̃
siˀsemɨ̃	s iˀ s e m ɨ̃
kataˀpɨ	k a t aˀ p ɨ
miaɲe	m i a ɲ e
asoβa	a s o β a
o*imɨ̃	o * i m ɨ̃
acoai	a c o a i
βeˀse	β eˀ s e
βu*eβɨ̃	β u * e β ɨ̃
teteɨ	t e t e ɨ
pinime	p i n i m e
piˀʔa	p iˀ ʔ a
ĩnsipɨ	ĩ n s i p ɨ
ɦaˀ*ɨ̃cjɨ̃sosikʰɨm	ɦ aˀ * ɨ̃ c j ɨ̃ s o s i kʰ ɨ m
aˀpẽɲjũ	aˀ p ẽ ɲ j ũ
utʰiˀkiɨ	u tʰ iˀ k i ɨ
ca*ũ*mɨ̃	c a * ũ * m ɨ̃
kʰweˀkomɨ̃	kʰ w eˀ k o m ɨ̃
iˀkʰowɨˀ	iˀ kʰ o w ɨˀ
kʰomamɨ̃	kʰ o m a m ɨ̃
ɲjaɲjeˀ	ɲ j a ɲ j eˀ
eˀʔamɨ̃	eˀ ʔ a m ɨ̃
opɨ	o p ɨ
pãĩɨ̃	p ã ĩ ɨ̃
ɲakɨ	ɲ a k ɨ
kaʔimɨ̃	k a ʔ i m ɨ̃
riɦomõ	r i ɦ o m õ
apecjeˀ	a p e c j eˀ
kʰũnkʰũce	kʰ ũ n kʰ ũ c e
poˀnɨmɨ̃	p oˀ n ɨ m ɨ̃
aipa	a i p a
toa	t o a
kʰa	kʰ a
oowɨˀ	o o w ɨˀ
sẽ*sẽ	s ẽ * s ẽ
ɲjãɲjẽ	ɲ j ã ɲ j ẽ
caˀsamɨ̃	c aˀ s a m ɨ̃
pia	p i a
cĩõ	c ĩ õ
tʰõɲõɲje	tʰ õ ɲ õ ɲ j e
ɲase	ɲ a s e
nẽatʰõ	n ẽ a tʰ õ
hooɦomɨ̃	h o o ɦ o m ɨ̃
cjecjawaʔi	c j e c j a w a ʔ i
paˀ*ĩmɨ̃	p aˀ * ĩ m ɨ̃
po*o	p o * o
waʔi	w a ʔ i
cjɨsosiˀkɨamɨ̃	c j ɨ s o s iˀ k ɨ a m ɨ̃
ɦaˀkɨ	ɦ aˀ k ɨ
cjɨsosikʰɨmɨ̃	c j ɨ s o s i kʰ ɨ m ɨ̃
ceˀcome	c eˀ c o m e
caˀsam	c aˀ s a m
e*omɨ	e * o m ɨ
haˀkʰɨˀ	h aˀ kʰ ɨˀ
utiˀkirɨ	u t iˀ k i r ɨ
ɲaɲomɨ̃	ɲ a ɲ o m ɨ̃
asiɾeɾewɨ	a s i ɾ e ɾ e w ɨ
e*omɨ̃	e * o m ɨ̃
cjokʰoˀ*aˀ	c j o kʰ oˀ * aˀ
kʰweˀkʰomɨ̃	kʰ w eˀ kʰ o m ɨ̃
coˀɦɨ*ɨ	c oˀ ɦ ɨ * ɨ
ɸemɨ̃	ɸ e m ɨ̃
piʔa	p i ʔ a
asimakʰa	a s i m a kʰ a
ha*a	h a * a
unku	u n k u
utiˀirɨ	u t iˀ i r ɨ
cɨˀcɨ	c ɨˀ c ɨ
ceˀcoce	c eˀ c o c e
siɦopɨ	s i ɦ o p ɨ
oopɨˀ	o o p ɨˀ
ɾeʔomɨ̃	ɾ e ʔ o m ɨ̃
maˀɲa	m aˀ ɲ a
ɦa*ɨcjo*omɨ̃	ɦ a * ɨ c j o * o m ɨ̃
mĩkapɨ	m ĩ k a p ɨ
oɦeco	o ɦ e c o
hu*epɨ̃	h u * e p ɨ̃
kaimõ	k a i m õ
tʰoɲjoɲje	tʰ o ɲ j o ɲ j e
ci*imẽ	c i * i m ẽ
ma*a	m a * a
ɾãɲjaˀpeomõ	ɾ ã ɲ j aˀ p e o m õ
aˀpeɨãmaˀmo	aˀ p e ɨ ã m aˀ m o
siɦoˀpɨ	s i ɦ oˀ p ɨ
hɨepɨ	h ɨ e p ɨ
kuˀtʰumamɨ̃	k uˀ tʰ u m a m ɨ̃
ukupia*mɨ̃	u k u p i a * m ɨ̃
ɦaʔo	ɦ a ʔ o
pomɨ̃	p o m ɨ̃
cokʰo*a	c o kʰ o * a
asimaka	a s i m a k a
haˀkʰowɨˀ	h aˀ kʰ o w ɨˀ
korebahɨ	k o r e b a h ɨ
makʰa	m a kʰ a
ʔeosẽ*ẽ	ʔ e o s ẽ * ẽ
cokʰõɲã	c o kʰ õ ɲ ã
kʰomɨ̃	kʰ o m ɨ̃
sĩɦoˀpɨa	s ĩ ɦ oˀ p ɨ a
peˀumɨ̃	p eˀ u m ɨ̃
haˀ*akʰowɨˀ	h aˀ * a kʰ o w ɨˀ
kʰwekʰomɨ̃	kʰ w e kʰ o m ɨ̃
tʰaɾapɨ	tʰ a ɾ a p ɨ
siˀsia	s iˀ s i a
onona	o n o n a
ʔiɦaˀce	ʔ i ɦ aˀ c e
kʰaimɨ̃	kʰ a i m ɨ̃
coko*aˀ	c o k o * aˀ
ha*ɨ̃	h a * ɨ̃
o	o
kunkuce	k u n k u c e
sunkiˀkʰa	s u n k iˀ kʰ a
oˀɾomɨ̃	oˀ ɾ o m ɨ̃
kũnaeawa	k ũ n a e a w a
poˀnɨmɨ	p oˀ n ɨ m ɨ
a*i	a * i
βeβɨ	β e β ɨ
cjɨ̃mɨ̃	c j ɨ̃ m ɨ̃
swiˀswemɨ̃	s w iˀ s w e m ɨ̃
aˀsoβa	aˀ s o β a
huepɨ	h u e p ɨ
ʔβu*eβɨ	ʔ β u * e β ɨ
apeɦamɨ	a p e ɦ a m ɨ
ɳãũɲãũmɨ̃	ɳ ã ũ ɲ ã ũ m ɨ̃
aɨ	a ɨ
kʰata	kʰ a t a
cjo*oˀce	c j o * oˀ c e
ɦaɨ̃cjɨsosikʰɨmɨ̃	ɦ a ɨ̃ c j ɨ s o s i kʰ ɨ m ɨ̃
ka*imɨ̃	k a * i m ɨ̃
ɦɨ̃ntʰɨ	ɦ ɨ̃ n tʰ ɨ
miˀkʰapɨ	m iˀ kʰ a p ɨ
siˀɾemo	s iˀ ɾ e m o
kʰowɨˀ	kʰ o w ɨˀ
aso	a s o
mahaˀɲjẽ	m a h aˀ ɲ j ẽ
cuʔcu	c u ʔ c u
mĩʔaˀ	m ĩ ʔ aˀ
tʰõɲjoɲjeˀ	tʰ õ ɲ j o ɲ j eˀ
ha*aɲjɨ̃ne*eˀɲjɨ̃maˀmɨ̃	h a * a ɲ j ɨ̃ n e * eˀ ɲ j ɨ̃ m aˀ m ɨ̃
comɨˀ	c o m ɨˀ
ʔeoseˀβẽ	ʔ e o s eˀ β ẽ
haˀkʰɨ	h aˀ kʰ ɨ
haɨɦoɦomõ	h a ɨ ɦ o ɦ o m õ
kʰomaɲe	kʰ o m a ɲ e
βɨ*eˀ	β ɨ * eˀ
ɦa*ɨkʰokʰomaˀmɨ̃	ɦ a * ɨ kʰ o kʰ o m aˀ m ɨ̃
neɲɨ	n e ɲ ɨ
soˀtʰoˀ	s oˀ tʰ oˀ
ɦa*ɨcjɨsosikʰɨm	ɦ a * ɨ c j ɨ s o s i kʰ ɨ m
